SSSSSSSSSSSSSS
SGGPGGRGGGGGGG  
SGGPGGRGGGGGGG
SGGPGGRGGGGGGG
SGGPGGRGGGGGGG
SGGPGGRGGGGGGG
SGGPGGRGGGGGGG
SSSSSSSSSSSSSS
TTTTTTTTTTTTTT
TTTTTTTTTTTTTT